11111111111111
100000000000E1
10101010001111
10100010101001
10100110101011
1P000000100001
11111111111111